1111111111111111111111111111111111111111111111111111111111111111
1000011111000000000111111111111100000000000000000000000000000001
100011E000000000000000000000000000000000000000000000000000C00P01
1111111111111111111111111111111111111111111111111111111111111111