11111111111111111
10000111110000001
100011E0000C00P01
11111111111111111