11111111111111111
10010000000000001
10000000000000001
10010000000000001
10000111110000001
100011E0000C00P01
11111111111111111