1111111111111
1001C000000C1
10000111110P1
100011E000001
1111111111111