11111111111111111
1001C000000000001
10000000000000001
10010000000000001
100001111100000P1
100011E0000000001
11111111111111111