11111111111111111111111
1001C000000000000C00001
100000000C00000C0000001
10010000000000000000001
1000011111000000C0000P1
100011E00000000000C0001
11111111111111111111111