111111111111111111
10000P000000000001
100000000000000001
100000000000000001
1000000000B0000001
100000000000000001
1000000000000000E1
111111111111111111