1111111111111111111111111111
1E10000011010000001100000001
100000B0010B00C0000001100001
1000000001000100100100100001
1001110011010010001000100001
100B00000000000100100C000001
1000001C100C0010100000C0B001
10000010100B001010B000000001
100B00000000001000000C000001
100C001110C000001C00000000P1
1111111111111111111111111111