11111111111111111
10000101000000001
10C0100001010C001
100000001000B0001
100B0010000000001
1001000000000C001
1C0C11E0000C00P01
11111111111111111