11111111111111111
10000101000000001
10001000010100001
10000000100000001
10000010010000001
10010000110000001
100011E0010C00P01
11111111111111111