11111111111111111
10000101000000001
10001000010100001
100000001000B0001
100B0010000000001
10010000000000001
100011E0000C00P01
11111111111111111